abort=abortar
about =sobre 
add =adicionar 
adjust = ajustar
adjust water budget on =ajustar percentagem de rega para 
adjust water budget=adjust water budget
apply =aplicar 
apply percentage of =
apply percentage=aplicar percentagem
assign controller=associar controlador
attach =associar 
can you help me?=pode ajudar-me?
cancel =cancelar 
cancel demo=cancelar demo 
cancel demonstration=cancelar demostração
cancel=cancelar
confirm=confirmar
controller number is =o número do controlador é 
controller=controlador
controllerId=id de controlador
create =criar 
debug bot=depurar bot
definitely not=definitivamente, não
disable plan on =desactivar o plano no 
disable plan=desativar plano
do it=faz
don't do it=não faça
don't know what to do=eu não sei o que fazer
eMailAddress=endereço de e-mail
enable =ativar 
exactly=exatamente
exit demo=sair da demo
exit demonstration=sair da demonstração
exit=sair
for =para 
get info about =obter informação sobre 
get info about=obter informação sobre
get info=obter informação
Get started=Iniciar
help me=ajuda-me
help=ajuda
I agree=concordo
I disagree=eu discordo
I don't mind=não me importo
I don't think so=não concordo
I don't want that=não quero isso
I need help=necessito de ajuda
I want to know more about=quero saber mais acerca
I want to know more=quero saber mais
i want to learn=eu quero aprender
i want to register=eu quero registar-me
i want to remove =eu quer remover 
I want to signup=quero inscrever-me
info about =informação sobre 
info about=informação sobre
learn=aprender
list =listar 
list controllers from =lista controladores de 
list gardens in =lista jardins em
list gardens=lista jardins
my =meu 
my controller id is =O meu id do controlador é 
my email is =o meu endereço de e-mail é 
new =novo 
no=não
not interested=não estou interessado
not really=nem por isso
of course=claro
pending orders for =pedidos pendentes para 
pending orders=pedidos pendentes
pending requests for =pedidos pendentes para 
pending requests=pedidos pendentes
play=
register =registar
register controller =registar controlador 
register=registar 
remove =remover 
resume =retomar 
set irrigation on =colocar irrigação no 
set irrigation=colocar irrigação
show =mostrar 
show gardens=mostrar jardins
show me info about =mostra-me informação sobre 
show me info=mostra-me informação
show me my =mostra-me os meus 
show my =mostra os meus 
sign up=registar-me
signup=inscrever
sounds good=parece-me bem
start =começar 
start demo=começar demo
start demonstration=começar demonstração
Start=Inicio
stop demo=parar demo
stop demonstration=parar demonstração
stop following plan on =parar de seguir o plano de rega no 
stop following plan=parar de seguir plano de rega
stop=parar
sure=claro
thanks but no=obrigado, mas dispenso
that's correct=está correto
welcome event=evento de boas-vindas
what are my =quais são os meus 
what can I ask you?=o que posso perguntar-te?
what can I do=em que posso ser útil
what can you do?=o que és capaz de fazer ?
yes=sim